2141011451101412
0025121512125200
0422030351302240
1100004542000011
5113101001013115
0000212442120000
0141161551611410