4444444444444444
4002200260033004
4002200260033004
5626262262626224
4003300260022005
5003300260022004
4434414444144344